####################
#S.................#
## ## ######## ## ##
 # #  o .... o  # #
## ############## ##
#o .............. o#
## ######  ###### ##
## ######  ###### ##
#o .............. o#
#########  #########
        #  #
       #0123#
       ######