#####################
#S..#...........#...#
#.#.#.#.#####.#.#.#.#
#.#...#...#...#...#.#
###.#####.#.#####.###
#.#...#...0...#...#.#
#.#.#.#.## ##.#.#.#.#
#...#...#123#...#...#
#.#.#.#.#####.#.#.#.#
#.#...#.......#...#.#
###.#####.#.#####.###
#.#...#...#...#...#.#
#.#.#.#.#####.#.#.#.#
#...#..... .....#...#
#####################